0x0E 0x08 0x08 0x08 0x08 0x08 0x09 0x0C 0x0A 0x0A 0x09 0x0F 0x0C 0x08 0x09 0x0F
0x0D 0x05 0x05 0x05 0x05 0x05 0x05 0x04 0x0A 0x09 0x04 0x0B 0x05 0x06 0x01 0x0D
0x05 0x04 0x02 0x02 0x02 0x02 0x03 0x04 0x0A 0x01 0x04 0x0A 0x01 0x0F 0x05 0x07
0x05 0x04 0x08 0x08 0x08 0x0A 0x09 0x04 0x0A 0x03 0x06 0x0A 0x03 0x0F 0x06 0x09
0x06 0x01 0x07 0x05 0x05 0x0F 0x05 0x04 0x0A 0x09 0x0C 0x0A 0x08 0x08 0x08 0x01
0x0F 0x06 0x0A 0x03 0x04 0x0A 0x03 0x04 0x0A 0x01 0x04 0x0B 0x05 0x05 0x05 0x07
0x0C 0x0A 0x0A 0x0A 0x01 0x0C 0x08 0x02 0x0A 0x03 0x06 0x0A 0x02 0x02 0x00 0x0B
0x06 0x0A 0x08 0x09 0x05 0x05 0x07 0x0C 0x09 0x0E 0x0A 0x0B 0x0E 0x0B 0x06 0x09
0x0E 0x0B 0x05 0x05 0x07 0x04 0x09 0x06 0x01 0x0E 0x0A 0x0B 0x0C 0x0A 0x09 0x05
0x0C 0x0A 0x02 0x03 0x0F 0x06 0x02 0x09 0x05 0x0C 0x08 0x0A 0x00 0x0A 0x01 0x05
0x04 0x0A 0x08 0x09 0x0C 0x0A 0x09 0x05 0x05 0x05 0x05 0x0F 0x06 0x0B 0x05 0x05
0x04 0x0A 0x01 0x05 0x05 0x0F 0x05 0x05 0x05 0x05 0x05 0x0C 0x0A 0x0A 0x03 0x05
0x04 0x0A 0x02 0x03 0x04 0x0A 0x02 0x01 0x05 0x04 0x01 0x05 0x0C 0x08 0x09 0x05
0x06 0x0A 0x09 0x0F 0x04 0x09 0x0D 0x05 0x05 0x05 0x05 0x05 0x05 0x05 0x05 0x05
0x0C 0x0B 0x05 0x0D 0x05 0x05 0x07 0x05 0x05 0x06 0x01 0x06 0x02 0x00 0x01 0x05
0x06 0x0B 0x06 0x02 0x02 0x03 0x0E 0x03 0x06 0x0A 0x03 0x0E 0x0B 0x07 0x06 0x03